{
  "welcomeMessage": "The engine is alive.",
  "map": {
    "default": {
      "width": 20,
      "height": 10,
      "tiles": [
        "####################",
        "#..................#",
        "#...@..............#",
        "#..................#",
        "#..................#",
        "#..................#",
        "#..................#",
        "#..................#",
        "#..................#",
        "####################"
      ]
    }
  }
}